...s......
.s.s...s..
.....s....
....z...s.
.s......s.
..........