s........s..
s.s.........
s.s.......s.
s.s...s...s.
s.s.s.s.s.s.
s...s...s.s.
s.........s.
z...........
DRT