........s..
...s.......
...........
........s.s
...........
..s........
..........z
DN