s......s.....ss
z..s...s......s
.s.s...........
.....ss..s.s...
..ss.....s..sss
.........s..s..
s....ss..s.sss.
s..ssss..s.....
DRT